XXXXXXXX
XOOOOXAX
XOXXOXOX
XOXOOOOX
XOXOXOX
XOXOXOOX
XOXOOOOX
XBXXOO