XXXXXXXX
XOOOOXAX
XOXXOXOX
XOXOOXOX
XOXOXXOX
XOXOXOOX
BOXOOOXX
XXXXXXXX